"aa" = (/obj/effect/turf_decal/tile/neutral{dir = 1},/obj/effect/turf_decal/tile/neutral,/obj/effect/turf_decal/tile/neutral{dir = 4},/obj/effect/turf_decal/tile/neutral{dir = 8},/turf/open/floor/plasteel,/area/space)
"ab" = (/turf/closed/wall,/area/space)
"ac" = (/obj/machinery/atmospherics/pipe/simple/supply/hidden{dir = 6},/turf/open/floor/plasteel,/area/space)
"ad" = (/obj/structure/table/reinforced,/obj/machinery/door/firedoor,/obj/machinery/door/window/westleft{dir = 2; name = "Cargo Desk"; req_access_txt = "0"},/obj/machinery/atmospherics/pipe/simple/supply/hidden,/turf/open/floor/plasteel,/area/space)
"ae" = (/obj/effect/spawner/lootdrop/maintenance,/obj/effect/turf_decal/bot,/turf/open/floor/plasteel,/area/space)
"af" = (/obj/effect/decal/cleanable/dirt,/obj/effect/turf_decal/delivery,/turf/open/floor/plasteel,/area/space)
"ag" = (/obj/effect/spawner/structure/window/reinforced,/turf/open/floor/plating,/area/space)
"ah" = (/obj/structure/table/reinforced,/obj/machinery/door/firedoor,/obj/machinery/door/window/westleft{dir = 2; name = "Cargo Desk"; req_access_txt = "0"},/turf/open/floor/plasteel,/area/space)
"ai" = (/obj/effect/decal/cleanable/dirt,/obj/effect/turf_decal/tile/neutral{dir = 1},/obj/effect/turf_decal/tile/neutral,/obj/effect/turf_decal/tile/neutral{dir = 4},/obj/effect/turf_decal/tile/neutral{dir = 8},/turf/open/floor/plasteel,/area/space)
"aj" = (/obj/effect/decal/cleanable/oil,/obj/effect/turf_decal/tile/neutral{dir = 1},/obj/effect/turf_decal/tile/neutral,/obj/effect/turf_decal/tile/neutral{dir = 4},/obj/effect/turf_decal/tile/neutral{dir = 8},/turf/open/floor/plasteel,/area/space)
"ak" = (/obj/effect/decal/cleanable/wrapping,/turf/open/floor/plasteel,/area/space)
"al" = (/obj/structure/closet/crate,/obj/effect/spawner/lootdrop/maintenance/two,/obj/effect/turf_decal/bot,/turf/open/floor/plasteel,/area/space)
"am" = (/obj/effect/decal/cleanable/dirt,/obj/effect/spawner/lootdrop/maintenance,/obj/effect/turf_decal/delivery,/turf/open/floor/plasteel,/area/space)
"an" = (/obj/machinery/requests_console{department = "Cargo Bay"; departmentType = 2; pixel_x = -32},/obj/machinery/computer/cargo{dir = 4},/obj/effect/turf_decal/tile/brown{dir = 1},/obj/effect/turf_decal/tile/brown{dir = 4},/turf/open/floor/plasteel,/area/space)
"ao" = (/obj/structure/chair/office{dir = 1},/obj/machinery/atmospherics/pipe/simple/supply/hidden,/obj/effect/turf_decal/tile/brown{dir = 1},/obj/effect/turf_decal/tile/brown{dir = 4},/turf/open/floor/plasteel,/area/space)
"ap" = (/obj/machinery/atmospherics/pipe/simple/scrubbers/hidden{dir = 4},/obj/effect/turf_decal/tile/neutral{dir = 1},/obj/effect/turf_decal/tile/neutral,/obj/effect/turf_decal/tile/neutral{dir = 4},/obj/effect/turf_decal/tile/neutral{dir = 8},/turf/open/floor/plasteel,/area/space)
"aq" = (/obj/machinery/atmospherics/components/unary/vent_scrubber/on{dir = 8},/obj/effect/turf_decal/tile/neutral{dir = 1},/obj/effect/turf_decal/tile/neutral,/obj/effect/turf_decal/tile/neutral{dir = 4},/obj/effect/turf_decal/tile/neutral{dir = 8},/turf/open/floor/plasteel,/area/space)
"ar" = (/obj/structure/chair/office{dir = 1},/obj/effect/turf_decal/tile/brown{dir = 1},/obj/effect/turf_decal/tile/brown{dir = 4},/turf/open/floor/plasteel,/area/space)
"as" = (/obj/machinery/atmospherics/pipe/simple/supply/hidden{dir = 4},/turf/open/floor/plasteel,/area/space)
"at" = (/obj/effect/turf_decal/bot,/obj/structure/closet/crate/freezer,/obj/item/pizzabox/pineapple,/obj/item/pizzabox/mushroom,/obj/item/pizzabox/vegetable,/obj/item/pizzabox/meat,/turf/open/floor/plasteel,/area/space)
"au" = (/obj/effect/decal/cleanable/dirt,/obj/effect/spawner/lootdrop/maintenance,/obj/effect/turf_decal/bot,/turf/open/floor/plasteel,/area/space)
"av" = (/obj/effect/turf_decal/delivery,/turf/open/floor/plasteel,/area/space)
"aw" = (/obj/item/stamp{pixel_x = -3; pixel_y = 3},/obj/item/stamp/denied{pixel_x = 4; pixel_y = -2},/obj/structure/table,/obj/effect/turf_decal/tile/brown{dir = 1},/obj/effect/turf_decal/tile/brown{dir = 4},/turf/open/floor/plasteel,/area/space)
"ax" = (/obj/item/clothing/suit/hazardvest{desc = "A high-visibility lifejacket complete with whistle and slot for oxygen tanks."; name = "emergency lifejacket"},/obj/item/clothing/suit/hazardvest{desc = "A high-visibility lifejacket complete with whistle and slot for oxygen tanks."; name = "emergency lifejacket"},/obj/item/clothing/suit/hazardvest{desc = "A high-visibility lifejacket complete with whistle and slot for oxygen tanks."; name = "emergency lifejacket"},/obj/item/clothing/suit/hazardvest{desc = "A high-visibility lifejacket complete with whistle and slot for oxygen tanks."; name = "emergency lifejacket"},/obj/item/clothing/suit/hazardvest{desc = "A high-visibility lifejacket complete with whistle and slot for oxygen tanks."; name = "emergency lifejacket"},/obj/item/tank/internals/emergency_oxygen{pixel_x = 3},/obj/item/tank/internals/emergency_oxygen{pixel_x = 3},/obj/item/tank/internals/emergency_oxygen{pixel_x = 3},/obj/item/tank/internals/emergency_oxygen{pixel_x = 3},/obj/item/tank/internals/emergency_oxygen{pixel_x = 3},/obj/item/clothing/mask/breath{pixel_x = -3; pixel_y = -3},/obj/item/clothing/mask/breath{pixel_x = -3; pixel_y = -3},/obj/item/clothing/mask/breath{pixel_x = -3; pixel_y = -3},/obj/item/clothing/mask/breath{pixel_x = -3; pixel_y = -3},/obj/item/clothing/mask/breath{pixel_x = -3; pixel_y = -3},/obj/item/clothing/head/hardhat/orange{name = "protective hat"; pixel_y = 9},/obj/item/clothing/head/hardhat/orange{name = "protective hat"; pixel_y = 9},/obj/item/clothing/head/hardhat/orange{name = "protective hat"; pixel_y = 9},/obj/item/clothing/head/hardhat/orange{name = "protective hat"; pixel_y = 9},/obj/item/clothing/head/hardhat/orange{name = "protective hat"; pixel_y = 9},/obj/structure/closet/crate/internals,/obj/effect/turf_decal/bot,/turf/open/floor/plasteel,/area/space)
"ay" = (/obj/effect/turf_decal/tile/brown{dir = 1},/obj/effect/turf_decal/tile/brown{dir = 4},/turf/open/floor/plasteel,/area/space)
"az" = (/obj/machinery/disposal/bin,/obj/structure/disposalpipe/trunk,/obj/effect/turf_decal/tile/brown{dir = 1},/obj/effect/turf_decal/tile/brown{dir = 4},/turf/open/floor/plasteel,/area/space)
"aA" = (/obj/machinery/status_display/supply{dir = 4; layer = 4; pixel_x = -32},/obj/machinery/computer/bounty{dir = 4},/turf/open/floor/plasteel,/area/space)
"aB" = (/obj/machinery/atmospherics/components/unary/vent_pump/on{dir = 1},/turf/open/floor/plasteel,/area/space)
"aC" = (/obj/structure/disposalpipe/segment{dir = 6},/turf/open/floor/plasteel,/area/space)
"aD" = (/obj/structure/disposalpipe/junction{dir = 8},/obj/machinery/atmospherics/pipe/simple/scrubbers/hidden{dir = 6},/turf/open/floor/plasteel,/area/space)
"aE" = (/obj/effect/turf_decal/tile/brown{dir = 1},/obj/effect/turf_decal/tile/brown{dir = 4},/obj/effect/spawner/lootdrop/maintenance,/turf/open/floor/plasteel,/area/space)
"aF" = (/obj/machinery/atmospherics/pipe/simple/supply/hidden{dir = 10},/turf/open/floor/plasteel,/area/space)
"aG" = (/obj/machinery/door/firedoor,/obj/machinery/door/airlock/mining/glass{name = "Cargo Office"; req_access_txt = "0"},/obj/structure/disposalpipe/segment{dir = 4},/obj/machinery/atmospherics/pipe/simple/scrubbers/hidden{dir = 4},/turf/open/floor/plasteel,/area/space)
"aH" = (/obj/machinery/photocopier,/obj/machinery/light,/obj/machinery/camera{c_tag = "Cargo Office"; dir = 1},/turf/open/floor/plasteel,/area/space)
"aI" = (/obj/machinery/atmospherics/pipe/simple/scrubbers/hidden{dir = 8},/turf/open/floor/plasteel,/area/space)
"aJ" = (/obj/structure/disposalpipe/segment,/obj/structure/cable,/turf/open/floor/plasteel,/area/space)
"aK" = (/obj/machinery/atmospherics/components/unary/vent_scrubber/on{dir = 1},/obj/machinery/autolathe,/turf/open/floor/plasteel,/area/space)
"aL" = (/obj/effect/spawner/lootdrop/maintenance,/turf/open/floor/plasteel,/area/space)
"aM" = (/obj/effect/spawner/structure/window/reinforced,/obj/machinery/atmospherics/pipe/simple/scrubbers/hidden,/turf/open/floor/plating,/area/space)
"aN" = (/obj/structure/disposalpipe/segment,/obj/structure/cable,/obj/machinery/door/airlock/mining/glass{name = "Cargo Office"; req_access_txt = "0"},/turf/open/floor/plasteel,/area/space)
"aO" = (/obj/structure/table,/obj/item/clipboard,/obj/item/folder/yellow,/turf/open/floor/plasteel,/area/space)
"aP" = (/obj/structure/disposalpipe/segment{dir = 5},/obj/machinery/atmospherics/components/unary/vent_pump/on{dir = 1},/obj/effect/turf_decal/tile/brown{dir = 1},/obj/effect/turf_decal/tile/brown{dir = 4},/obj/structure/cable,/turf/open/floor/plasteel,/area/space)
"aQ" = (/obj/machinery/disposal/bin,/obj/structure/disposalpipe/trunk{dir = 8},/obj/effect/turf_decal/tile/brown{dir = 1},/obj/effect/turf_decal/tile/brown,/obj/effect/turf_decal/tile/brown{dir = 4},/turf/open/floor/plasteel,/area/space)
"aR" = (/obj/structure/closet/crate/secure/weapon,/obj/item/gun/ballistic/automatic/c20r/toy/unrestricted,/obj/item/gun/ballistic/automatic/toy/unrestricted,/turf/open/floor/plasteel,/area/space)
"aS" = (/obj/structure/cable,/turf/open/floor/plasteel,/area/space)
"aT" = (/obj/machinery/computer/bounty{dir = 8},/obj/effect/turf_decal/tile/brown,/obj/effect/turf_decal/tile/brown{dir = 4},/turf/open/floor/plasteel,/area/space)
"aU" = (/obj/machinery/status_display/supply{dir = 4; layer = 4; pixel_x = -32},/obj/structure/filingcabinet,/obj/effect/turf_decal/tile/brown{dir = 1},/obj/effect/turf_decal/tile/brown{dir = 8},/turf/open/floor/plasteel,/area/space)
"aV" = (/obj/effect/decal/cleanable/dirt,/obj/structure/closet/crate{icon_state = "crateopen"},/obj/effect/turf_decal/delivery,/obj/item/gun/ballistic/shotgun/toy/crossbow,/turf/open/floor/plasteel,/area/space)
"aW" = (/obj/machinery/computer/cargo{dir = 8},/obj/effect/turf_decal/tile/brown,/obj/effect/turf_decal/tile/brown{dir = 4},/turf/open/floor/plasteel,/area/space)
"aX" = (/obj/structure/table,/obj/machinery/requests_console{department = "Cargo Bay"; departmentType = 2; pixel_x = -30},/obj/item/pen,/obj/effect/turf_decal/tile/brown{dir = 1},/obj/effect/turf_decal/tile/brown,/obj/effect/turf_decal/tile/brown{dir = 8},/obj/item/paper_bin/carbon{layer = 2.9},/turf/open/floor/plasteel,/area/space)
"aY" = (/obj/structure/table,/obj/item/pen,/obj/item/radio/intercom{pixel_y = -26},/obj/item/paper_bin{layer = 2.9},/obj/structure/extinguisher_cabinet{pixel_x = -26},/turf/open/floor/plasteel,/area/space)
"aZ" = (/obj/item/radio/intercom{pixel_y = -35},/obj/machinery/computer/security/qm{dir = 8},/obj/effect/turf_decal/tile/brown,/obj/effect/turf_decal/tile/brown{dir = 4},/obj/effect/turf_decal/tile/brown{dir = 8},/turf/open/floor/plasteel,/area/space)
"ba" = (/obj/effect/decal/cleanable/dirt,/obj/structure/closet/crate,/obj/effect/turf_decal/delivery,/obj/item/gun/ballistic/shotgun/toy/unrestricted,/turf/open/floor/plasteel,/area/space)
"bb" = (/obj/structure/closet/secure_closet/quartermaster{req_access = null},/obj/machinery/atmospherics/pipe/simple/scrubbers/hidden,/obj/item/storage/belt/fannypack/yellow,/obj/effect/turf_decal/tile/brown{dir = 1},/obj/effect/turf_decal/tile/brown{dir = 4},/obj/effect/turf_decal/tile/brown{dir = 8},/turf/open/floor/plasteel,/area/space)
"bc" = (/obj/machinery/door/airlock/mining/glass{name = "Quartermaster"; req_access_txt = "0"},/obj/structure/disposalpipe/segment,/obj/machinery/atmospherics/pipe/simple/supply/hidden,/obj/machinery/door/firedoor,/obj/effect/turf_decal/tile/brown,/obj/effect/turf_decal/tile/brown{dir = 8},/obj/structure/cable,/turf/open/floor/plasteel,/area/space)
"bd" = (/obj/machinery/navbeacon{codes_txt = "delivery;dir=4"; dir = 4; freq = 1400; location = "QM #1"},/obj/effect/turf_decal/delivery,/turf/open/floor/plasteel,/area/space)
"be" = (/obj/structure/window/reinforced{dir = 1},/obj/effect/turf_decal/loading_area{dir = 4},/turf/open/floor/plasteel,/area/space)
"bf" = (/obj/effect/decal/cleanable/dirt,/obj/machinery/navbeacon{codes_txt = "delivery;dir=4"; dir = 4; freq = 1400; location = "QM #2"},/obj/effect/turf_decal/delivery,/mob/living/simple_animal/bot/mulebot{home_destination = "QM #3"; suffix = "#3"},/turf/open/floor/plasteel,/area/space)
"bg" = (/obj/effect/turf_decal/loading_area{dir = 4},/obj/effect/decal/cleanable/oil{icon_state = "floor5"},/turf/open/floor/plasteel,/area/space)
"bh" = (/obj/machinery/light{dir = 8},/obj/machinery/navbeacon{codes_txt = "delivery;dir=4"; dir = 4; freq = 1400; location = "QM #3"},/obj/effect/turf_decal/delivery,/turf/open/floor/plasteel,/area/space)
"bi" = (/obj/effect/decal/cleanable/dirt,/obj/effect/turf_decal/loading_area{dir = 4},/turf/open/floor/plasteel,/area/space)
"bj" = (/obj/machinery/camera{c_tag = "Cargo Bay - Port"; dir = 4; name = "cargo camera"},/obj/machinery/navbeacon{codes_txt = "delivery;dir=4"; dir = 4; freq = 1400; location = "QM #4"},/obj/effect/turf_decal/delivery,/mob/living/simple_animal/bot/mulebot{beacon_freq = 1400; home_destination = "QM #1"; suffix = "#1"},/turf/open/floor/plasteel,/area/space)
"bk" = (/obj/machinery/atmospherics/components/unary/vent_scrubber/on{dir = 1},/obj/effect/turf_decal/tile/brown{dir = 1},/obj/effect/turf_decal/tile/brown{dir = 8},/obj/structure/cable,/turf/open/floor/plasteel,/area/space)
"bl" = (/obj/structure/table/reinforced,/obj/item/paper_bin,/obj/effect/turf_decal/tile/brown{dir = 1},/obj/effect/turf_decal/tile/brown{dir = 4},/turf/open/floor/plasteel,/area/space)
"bm" = (/obj/structure/table/reinforced,/obj/item/storage/box/lights/mixed,/obj/item/radio/intercom{pixel_y = -26},/obj/effect/turf_decal/tile/brown{dir = 1},/obj/effect/turf_decal/tile/brown{dir = 4},/turf/open/floor/plasteel,/area/space)
"bn" = (/obj/effect/decal/cleanable/blood/tracks{icon_state = "tracks"; dir = 9},/turf/open/floor/plasteel,/area/space)
"bo" = (/obj/effect/decal/cleanable/dirt,/obj/machinery/light{dir = 2},/obj/structure/filingcabinet/chestdrawer,/obj/effect/turf_decal/tile/brown{dir = 1},/obj/effect/turf_decal/tile/brown{dir = 4},/turf/open/floor/plasteel,/area/space)
"bp" = (/obj/machinery/atmospherics/pipe/simple/supply/hidden,/turf/open/floor/plasteel,/area/space)
"bq" = (/obj/structure/chair/office{dir = 4},/turf/open/floor/plasteel,/area/space)
"br" = (/obj/structure/closet/crate{icon_state = "crateopen"},/obj/effect/spawner/lootdrop/maintenance,/obj/effect/turf_decal/bot,/obj/machinery/atmospherics/pipe/simple/supply/hidden,/turf/open/floor/plasteel,/area/space)
"bs" = (/obj/effect/turf_decal/bot,/obj/machinery/atmospherics/pipe/simple/supply/hidden,/obj/structure/closet/crate/secure/weapon,/obj/item/gun/ballistic/automatic/l6_saw/toy/unrestricted,/turf/open/floor/plasteel,/area/space)
"bt" = (/obj/effect/decal/cleanable/dirt,/obj/effect/turf_decal/tile/neutral{dir = 1},/obj/effect/turf_decal/tile/neutral,/obj/effect/turf_decal/tile/neutral{dir = 4},/obj/effect/turf_decal/tile/neutral{dir = 8},/obj/machinery/atmospherics/pipe/simple/supply/hidden,/turf/open/floor/plasteel,/area/space)
"bu" = (/obj/machinery/atmospherics/pipe/simple/scrubbers/hidden{dir = 10},/turf/open/floor/plasteel,/area/space)
"bv" = (/obj/effect/decal/cleanable/dirt,/obj/effect/turf_decal/bot,/obj/structure/closet/crate/secure/weapon,/obj/item/toy/balloon/syndicate,/obj/item/gun/ballistic/automatic/toy/pistol/unrestricted,/turf/open/floor/plasteel,/area/space)
"bw" = (/obj/machinery/atmospherics/pipe/simple/scrubbers/hidden{dir = 4},/obj/effect/turf_decal/tile/neutral{dir = 1},/obj/effect/turf_decal/tile/neutral,/obj/effect/turf_decal/tile/neutral{dir = 4},/obj/effect/turf_decal/tile/neutral{dir = 8},/obj/machinery/atmospherics/pipe/simple/supply/hidden,/turf/open/floor/plasteel,/area/space)
"bx" = (/obj/structure/closet/cardboard,/obj/effect/spawner/lootdrop/maintenance,/obj/effect/turf_decal/bot,/obj/machinery/atmospherics/pipe/simple/supply/hidden{dir = 9},/turf/open/floor/plasteel,/area/space)
"by" = (/obj/structure/table,/obj/item/clipboard,/obj/machinery/light,/obj/machinery/light_switch{pixel_y = -24},/obj/item/cartridge/quartermaster{pixel_x = 6; pixel_y = 5},/obj/item/cartridge/quartermaster,/obj/item/cartridge/quartermaster{pixel_x = -4; pixel_y = 7},/obj/item/coin/silver,/obj/item/stamp/qm,/obj/effect/turf_decal/tile/brown,/obj/effect/turf_decal/tile/brown{dir = 8},/turf/open/floor/plasteel,/area/space)
"bz" = (/obj/machinery/atmospherics/pipe/simple/scrubbers/hidden,/turf/open/floor/plasteel,/area/space)
"bA" = (/obj/machinery/atmospherics/pipe/manifold/scrubbers/hidden{dir = 8},/turf/open/floor/plasteel,/area/space)
"bB" = (/obj/structure/closet/crate/engineering,/turf/open/floor/plasteel,/area/space)
"bC" = (/obj/structure/closet/crate/secure/weapon,/obj/item/gun/ballistic/automatic/toy/unrestricted,/turf/open/floor/plasteel,/area/space)
"bD" = (/obj/structure/table/reinforced,/obj/effect/turf_decal/tile/brown{dir = 1},/obj/effect/turf_decal/tile/brown{dir = 4},/obj/item/taperecorder,/turf/open/floor/plasteel,/area/space)
"bE" = (/obj/item/stamp,/turf/open/floor/plasteel,/area/space)
"bG" = (/obj/machinery/atmospherics/pipe/simple/supply/hidden{dir = 4},/obj/machinery/atmospherics/pipe/simple/scrubbers/hidden,/turf/open/floor/plasteel,/area/space)
"bH" = (/obj/machinery/atmospherics/pipe/simple/scrubbers/hidden{dir = 6},/obj/effect/decal/cleanable/blood/tracks{icon_state = "tracks"; dir = 8},/turf/open/floor/plasteel,/area/space)
"bI" = (/obj/machinery/atmospherics/pipe/simple/supply/hidden,/obj/machinery/atmospherics/pipe/simple/scrubbers/hidden{dir = 8},/turf/open/floor/plasteel,/area/space)
"bK" = (/obj/machinery/atmospherics/pipe/simple/scrubbers/hidden{dir = 9},/obj/effect/decal/cleanable/blood/tracks{icon_state = "tracks"; dir = 8},/turf/open/floor/plasteel,/area/space)
"bL" = (/obj/effect/decal/cleanable/blood/splatter,/turf/open/floor/plasteel,/area/space)
"bM" = (/obj/effect/decal/cleanable/glass,/obj/effect/decal/cleanable/greenglow,/turf/open/floor/plasteel,/area/space)
"bN" = (/obj/effect/decal/cleanable/dirt,/obj/structure/window/reinforced,/obj/effect/turf_decal/loading_area{dir = 4},/obj/effect/decal/cleanable/blood/gibs/core,/turf/open/floor/plasteel,/area/space)
"bO" = (/obj/effect/decal/cleanable/blood,/turf/open/floor/plasteel,/area/space)
"bP" = (/obj/effect/turf_decal/tile/neutral{dir = 1},/obj/effect/turf_decal/tile/neutral,/obj/effect/turf_decal/tile/neutral{dir = 4},/obj/effect/turf_decal/tile/neutral{dir = 8},/obj/effect/decal/cleanable/blood/tracks{icon_state = "tracks"; dir = 5},/turf/open/floor/plasteel,/area/space)
"bQ" = (/obj/effect/decal/cleanable/blood/tracks,/turf/open/floor/plasteel,/area/space)
"bR" = (/obj/effect/spawner/lootdrop/maintenance,/obj/effect/turf_decal/bot,/obj/effect/decal/cleanable/blood/tracks{icon_state = "tracks"; dir = 10},/turf/open/floor/plasteel,/area/space)
"bS" = (/obj/effect/turf_decal/bot,/obj/effect/decal/cleanable/blood/tracks{icon_state = "tracks"; dir = 8},/mob/living/simple_animal/bot/mulebot{home_destination = "QM #3"; suffix = "#3"},/turf/open/floor/plasteel,/area/space)
"bT" = (/obj/effect/decal/cleanable/blood/tracks{icon_state = "tracks"; dir = 6},/turf/open/floor/plasteel,/area/space)
"bU" = (/obj/machinery/atmospherics/pipe/simple/scrubbers/hidden{dir = 8},/obj/effect/decal/cleanable/blood/splatter,/turf/open/floor/plasteel,/area/space)
"gA" = (/turf/open/floor/plasteel,/area/space)

(1,1,1) = {"
gAgAacasasasasasasaFayaVba
agadahagagababgAgAbpgAgAgA
anaoarawaEazaggAgAbrataeaf
aAaBaLakaCaDaGaIbubtaaaiaa
aYaOaHaSaJaKaggAbzbsaealam
ababababaNababgAbAbwapapaq
gAgAbLgAgAgAacasbGbxbvauav
gAaLbngAgAbHbIbUbKbPaaaaaa
bdbebQaRabaMbcagabbRbSaxaf
bfbggAbBabbbaPaQabaaaiaiaj
bhbibTbCabbkaSaTagbEbMgAgA
bjbNaLgAabaUbqaWaggAbOgAgA
gAgAgAgAabaXbyaZagblbmbDbo
"}
