"aa" = (/obj/effect/turf_decal/tile/blue{dir = 1},/obj/effect/turf_decal/tile/blue{dir = 8},/obj/effect/decal/cleanable/dirt/dust,/obj/effect/decal/cleanable/greenglow,/turf/open/floor/plasteel/white,/area/space)
"ab" = (/obj/machinery/portable_atmospherics/canister/oxygen{filled = 0},/obj/effect/turf_decal/box/white{color = "#52B4E9"},/obj/effect/turf_decal/tile/blue{dir = 8},/obj/effect/turf_decal/tile/blue{dir = 4},/obj/item/wrench/medical,/turf/open/floor/plasteel/freezer,/area/space)
"ac" = (/obj/machinery/door/firedoor,/obj/effect/turf_decal/tile/blue,/obj/effect/turf_decal/tile/blue{dir = 8},/obj/effect/turf_decal/tile/blue{dir = 4},/obj/effect/turf_decal/tile/blue{dir = 1},/obj/machinery/door/airlock/medical{name = "Psychology"; req_access_txt = "0"},/obj/effect/decal/cleanable/dirt/dust,/turf/open/floor/plasteel/white,/area/space)
"ad" = (/obj/effect/turf_decal/box/white{color = "#52B4E9"},/obj/machinery/holopad,/turf/open/floor/plasteel/white,/area/space)
"ae" = (/obj/structure/table/glass,/obj/item/storage/firstaid,/turf/open/floor/plasteel/white,/area/space)
"af" = (/turf/closed/wall,/area/space)
"ag" = (/obj/effect/spawner/structure/window,/obj/machinery/door/poddoor/preopen{id = "surgeryb"; name = "privacy shutter"},/obj/effect/decal/cleanable/glass,/turf/open/floor/plating,/area/space)
"ah" = (/obj/item/taperecorder,/obj/effect/decal/cleanable/blood/footprints{icon_state = "blood1"; dir = 8},/obj/machinery/light/dim{icon_state = "tube"; dir = 1},/turf/open/floor/plasteel/white,/area/space)
"ai" = (/obj/machinery/atmospherics/components/unary/vent_scrubber/on,/turf/open/floor/plasteel/white,/area/space)
"aj" = (/obj/effect/spawner/structure/window,/obj/machinery/door/poddoor/preopen{id = "surgeryb"; name = "privacy shutter"},/turf/open/floor/plating,/area/space)
"ak" = (/turf/closed/wall/r_wall,/area/space)
"al" = (/obj/effect/turf_decal/tile/blue{dir = 4},/obj/effect/turf_decal/tile/blue,/turf/open/floor/plasteel/white,/area/space)
"am" = (/obj/effect/turf_decal/tile/blue{dir = 1},/obj/effect/turf_decal/tile/blue{dir = 8},/obj/machinery/status_display/evac{pixel_x = -32; req_access_txt = "70"},/obj/structure/closet/secure_closet/psychology,/obj/machinery/light{dir = 8},/turf/open/floor/plasteel/white,/area/space)
"an" = (/obj/machinery/iv_drip,/obj/effect/turf_decal/tile/blue{dir = 1},/obj/effect/turf_decal/tile/blue{dir = 4},/obj/item/radio/intercom{pixel_y = 21},/turf/open/floor/plasteel/white,/area/space)
"ao" = (/obj/structure/table/optable,/obj/effect/turf_decal/tile/blue{dir = 1},/obj/effect/turf_decal/tile/blue{dir = 4},/obj/effect/decal/cleanable/vomit,/obj/effect/decal/cleanable/blood/old,/turf/open/floor/plasteel/white,/area/space)
"ap" = (/obj/machinery/computer/operating{dir = 8},/obj/effect/turf_decal/tile/blue{dir = 1},/obj/effect/turf_decal/tile/blue{dir = 4},/turf/open/floor/plasteel/white,/area/space)
"aq" = (/obj/structure/closet/secure_closet/medical2,/obj/effect/turf_decal/tile/blue{dir = 1},/obj/effect/turf_decal/tile/blue{dir = 4},/obj/effect/turf_decal/tile/blue,/obj/machinery/light/small{dir = 4},/turf/open/floor/plasteel/white,/area/space)
"ar" = (/obj/structure/closet/secure_closet/CMO,/obj/item/clothing/under/rank/medical/doctor,/obj/item/clothing/head/nursehat,/obj/effect/turf_decal/stripes/line{dir = 5},/obj/item/storage/firstaid/regular,/turf/open/floor/plasteel,/area/space)
"as" = (/obj/effect/decal/cleanable/dirt/dust,/turf/open/floor/carpet,/area/space)
"at" = (/turf/open/floor/plasteel/white,/area/space)
"au" = (/obj/effect/turf_decal/tile/blue{dir = 4},/obj/effect/turf_decal/tile/blue{dir = 8},/turf/open/floor/plasteel/white,/area/space)
"av" = (/obj/effect/turf_decal/tile/blue{dir = 4},/obj/effect/turf_decal/tile/blue{dir = 8},/obj/effect/decal/cleanable/dirt/dust,/turf/open/floor/plasteel/white,/area/space)
"aw" = (/obj/item/radio/intercom{pixel_x = 28},/obj/structure/table/wood,/obj/item/flashlight/lamp/green{pixel_y = 4},/turf/open/floor/carpet,/area/space)
"ax" = (/obj/effect/turf_decal/tile/blue{dir = 1},/obj/effect/turf_decal/tile/blue{dir = 4},/obj/effect/turf_decal/tile/blue{dir = 8},/obj/structure/bookcase/random/reference,/turf/open/floor/plasteel/white,/area/space)
"ay" = (/obj/effect/turf_decal/tile/blue{dir = 1},/obj/effect/turf_decal/tile/blue{dir = 4},/obj/structure/reagent_dispensers/water_cooler,/turf/open/floor/plasteel/white,/area/space)
"az" = (/turf/open/floor/carpet,/area/space)
"aA" = (/obj/structure/chair/comfy/brown{dir = 8},/turf/open/floor/carpet,/area/space)
"aB" = (/obj/structure/chair/office/light,/obj/effect/decal/cleanable/dirt/dust,/turf/open/floor/plasteel/white,/area/space)
"aC" = (/obj/effect/turf_decal/tile/blue{dir = 4},/obj/effect/turf_decal/tile/blue,/obj/item/kirbyplants/random,/turf/open/floor/plasteel/white,/area/space)
"aD" = (/obj/structure/closet/crate/freezer/blood,/obj/effect/turf_decal/tile/blue{dir = 8},/obj/effect/turf_decal/tile/blue{dir = 4},/obj/structure/sign/warning/chemdiamond{pixel_x = -32},/turf/open/floor/plasteel/freezer,/area/space)
"aE" = (/obj/structure/closet/crate/freezer/blood,/obj/effect/turf_decal/tile/blue{dir = 8},/obj/effect/turf_decal/tile/blue{dir = 4},/obj/effect/decal/cleanable/dirt/dust,/turf/open/floor/plasteel/freezer,/area/space)
"aF" = (/obj/machinery/disposal/bin,/obj/effect/turf_decal/tile/blue{dir = 1},/obj/effect/turf_decal/tile/blue{dir = 8},/obj/effect/turf_decal/tile/blue,/turf/open/floor/plasteel/white,/area/space)
"aG" = (/obj/structure/dresser,/obj/structure/mirror{pixel_x = 26},/obj/effect/turf_decal/tile/blue{dir = 4},/obj/effect/turf_decal/tile/blue{dir = 8},/turf/open/floor/plasteel/white,/area/space)
"aH" = (/obj/effect/turf_decal/tile/blue{dir = 8},/obj/effect/turf_decal/tile/blue,/turf/open/floor/plasteel/white,/area/space)
"aI" = (/obj/effect/decal/cleanable/blood/old,/turf/open/floor/plasteel/white,/area/space)
"aJ" = (/obj/effect/turf_decal/tile/blue{dir = 8},/obj/effect/turf_decal/tile/blue{dir = 4},/obj/machinery/atmospherics/components/unary/vent_pump/on{dir = 1},/turf/open/floor/plasteel/freezer,/area/space)
"aK" = (/obj/effect/turf_decal/tile/blue{dir = 8},/obj/effect/turf_decal/tile/blue{dir = 4},/obj/effect/decal/cleanable/plasma,/turf/open/floor/plasteel/freezer,/area/space)
"aL" = (/obj/effect/turf_decal/tile/blue{dir = 8},/obj/effect/turf_decal/tile/blue{dir = 4},/turf/open/floor/plasteel/freezer,/area/space)
"aM" = (/obj/machinery/atmospherics/components/unary/vent_pump/on{dir = 8},/obj/effect/decal/cleanable/dirt/dust,/turf/open/floor/plasteel/white,/area/space)
"aN" = (/obj/effect/turf_decal/tile/blue{dir = 8},/obj/effect/turf_decal/tile/blue,/obj/structure/filingcabinet/filingcabinet,/turf/open/floor/plasteel/white,/area/space)
"aO" = (/obj/effect/turf_decal/tile/blue{dir = 8},/obj/effect/turf_decal/tile/blue,/obj/structure/noticeboard{pixel_y = -32},/obj/structure/table/wood,/obj/machinery/computer/med_data/laptop{dir = 1; pixel_y = 4},/turf/open/floor/plasteel/white,/area/space)
"aP" = (/obj/effect/turf_decal/tile/blue{dir = 4},/obj/effect/turf_decal/tile/blue{dir = 8},/obj/effect/turf_decal/tile/blue,/obj/machinery/light_switch{pixel_x = 28},/obj/structure/table/wood,/obj/item/folder/white{pixel_x = -14; pixel_y = 3},/obj/item/paper_bin/carbon{pixel_x = 3; pixel_y = 2},/obj/item/pen,/turf/open/floor/plasteel/white,/area/space)
"aQ" = (/obj/machinery/holopad,/obj/effect/turf_decal/box/white{color = "#52B4E9"},/obj/effect/decal/cleanable/robot_debris,/turf/open/floor/plasteel/white,/area/space)
"aR" = (/obj/machinery/atmospherics/components/unary/vent_scrubber/on,/obj/effect/decal/cleanable/oil{icon_state = "floor6"},/turf/open/floor/plasteel/white,/area/space)
"aS" = (/obj/effect/turf_decal/tile/blue{dir = 1},/obj/effect/turf_decal/tile/blue{dir = 8},/obj/machinery/light/small{icon_state = "bulb"; dir = 8},/turf/open/floor/plasteel/white,/area/space)
"aT" = (/obj/machinery/door/airlock/medical/glass{name = "Medical Freezer"; req_access_txt = "0"},/obj/machinery/door/firedoor,/obj/effect/turf_decal/tile/blue{dir = 1},/obj/effect/turf_decal/tile/blue{dir = 4},/obj/effect/turf_decal/tile/blue{dir = 8},/obj/effect/turf_decal/tile/blue,/turf/open/floor/plasteel/white,/area/space)
"aU" = (/obj/machinery/light{dir = 8},/obj/machinery/status_display/ai{pixel_x = -32},/obj/machinery/atmospherics/components/unary/vent_scrubber/on{dir = 4},/obj/effect/turf_decal/stripes/line{dir = 4},/turf/open/floor/plasteel,/area/space)
"aV" = (/obj/effect/decal/cleanable/blood/splatter,/obj/machinery/light/broken,/turf/open/floor/plasteel/white,/area/space)
"aW" = (/obj/machinery/door/airlock/medical/glass{name = "Medical Freezer"; req_access_txt = "0"},/obj/machinery/door/firedoor,/obj/effect/turf_decal/tile/blue,/obj/effect/turf_decal/tile/blue{dir = 4},/obj/effect/turf_decal/tile/blue{dir = 8},/obj/effect/turf_decal/tile/blue{dir = 1},/obj/effect/decal/cleanable/dirt/dust,/turf/open/floor/plasteel/white,/area/space)
"aX" = (/obj/machinery/door/airlock/medical/glass{name = "Surgery B"; req_access_txt = "0"},/obj/machinery/door/firedoor,/obj/effect/turf_decal/tile/blue,/obj/effect/turf_decal/tile/blue{dir = 8},/obj/effect/turf_decal/tile/blue{dir = 4},/obj/effect/turf_decal/tile/blue{dir = 1},/obj/effect/decal/cleanable/blood/splatter,/turf/open/floor/plasteel/white,/area/space)
"aY" = (/obj/machinery/door/airlock/command{name = "Chief Medical Officer's Quarters"; req_access_txt = "0"},/obj/effect/turf_decal/tile/blue{dir = 4},/obj/effect/turf_decal/tile/blue{dir = 8},/turf/open/floor/plasteel/white,/area/space)
"aZ" = (/obj/effect/turf_decal/tile/blue{dir = 1},/obj/effect/turf_decal/tile/blue{dir = 4},/obj/effect/turf_decal/tile/blue{dir = 8},/turf/open/floor/plasteel/white,/area/space)
"ba" = (/obj/machinery/light_switch{pixel_x = 26; pixel_y = 26},/obj/effect/turf_decal/tile/blue{dir = 4},/obj/effect/turf_decal/tile/blue{dir = 8},/turf/open/floor/plasteel/white,/area/space)
"bb" = (/obj/effect/decal/cleanable/glass,/turf/open/floor/plasteel/white,/area/space)
"bc" = (/obj/effect/turf_decal/tile/blue{dir = 8},/obj/effect/turf_decal/tile/blue{dir = 4},/obj/machinery/atmospherics/components/unary/vent_scrubber/on,/turf/open/floor/plasteel/freezer,/area/space)
"bd" = (/obj/effect/turf_decal/tile/blue{dir = 1},/obj/effect/turf_decal/tile/blue,/obj/effect/turf_decal/tile/blue{dir = 4},/obj/effect/turf_decal/tile/blue{dir = 8},/obj/effect/decal/cleanable/dirt/dust,/turf/open/floor/plasteel,/area/space)
"be" = (/obj/effect/turf_decal/tile/blue{dir = 1},/obj/effect/turf_decal/tile/blue,/obj/effect/turf_decal/tile/blue{dir = 4},/obj/effect/turf_decal/tile/blue{dir = 8},/turf/open/floor/plasteel,/area/space)
"bf" = (/obj/machinery/atmospherics/components/unary/vent_pump/on{dir = 1},/obj/effect/turf_decal/tile/neutral{dir = 1},/obj/effect/turf_decal/tile/neutral,/obj/effect/turf_decal/tile/neutral{dir = 4},/obj/effect/turf_decal/tile/neutral{dir = 8},/turf/open/floor/plasteel,/area/space)
"bg" = (/obj/structure/bed,/obj/item/bedsheet/cmo,/obj/machinery/status_display/evac{pixel_x = 32},/obj/effect/turf_decal/tile/blue{dir = 4},/obj/effect/turf_decal/tile/blue{dir = 8},/obj/effect/decal/cleanable/dirt/dust,/obj/machinery/light/dim{icon_state = "tube"; dir = 4},/turf/open/floor/plasteel/white,/area/space)
"bi" = (/obj/effect/turf_decal/tile/neutral{dir = 1},/obj/effect/turf_decal/tile/neutral,/obj/effect/turf_decal/tile/neutral{dir = 4},/obj/effect/turf_decal/tile/neutral{dir = 8},/turf/open/floor/plasteel,/area/space)
"bj" = (/obj/structure/table/reinforced,/obj/item/storage/backpack/duffelbag/med/surgery,/obj/effect/turf_decal/tile/blue{dir = 8},/obj/effect/turf_decal/tile/blue,/obj/machinery/button/door{id = "surgeryb"; name = "Privacy Shutters Control"; pixel_y = -26},/turf/open/floor/plasteel/white,/area/space)
"bk" = (/obj/effect/turf_decal/tile/blue{dir = 1},/obj/effect/turf_decal/tile/blue{dir = 8},/obj/effect/turf_decal/tile/blue,/obj/machinery/light_switch{pixel_x = -26; pixel_y = -5},/obj/effect/decal/cleanable/dirt/dust,/turf/open/floor/plasteel/white,/area/space)
"bl" = (/obj/machinery/smartfridge/organ,/obj/effect/turf_decal/tile/blue{dir = 4},/obj/effect/turf_decal/tile/blue{dir = 8},/obj/effect/turf_decal/tile/blue,/turf/open/floor/plasteel/white,/area/space)
"bm" = (/obj/structure/sign/poster/official/get_your_legs{pixel_y = 32},/obj/structure/chair/sofa/right,/obj/item/toy/plush/moth,/obj/effect/decal/cleanable/dirt/dust,/turf/open/floor/carpet,/area/space)
"bn" = (/obj/effect/turf_decal/tile/blue{dir = 8},/obj/effect/turf_decal/tile/blue{dir = 4},/obj/machinery/airalarm{dir = 1; pixel_y = -22},/obj/machinery/light,/obj/item/healthanalyzer,/turf/open/floor/plasteel/freezer,/area/space)
"bo" = (/obj/item/storage/firstaid/brute,/obj/structure/table/glass,/turf/open/floor/plasteel/white,/area/space)
"bp" = (/obj/machinery/suit_storage_unit/cmo,/obj/effect/turf_decal/stripes/line{dir = 6},/obj/effect/decal/cleanable/dirt/dust,/turf/open/floor/plasteel,/area/space)
"bq" = (/obj/structure/table/glass,/obj/machinery/computer/med_data/laptop{dir = 1; pixel_y = 4},/obj/machinery/newscaster{pixel_y = -32},/obj/effect/turf_decal/tile/blue{dir = 4},/obj/effect/turf_decal/tile/blue{dir = 8},/obj/item/reagent_containers/food/drinks/britcup{pixel_x = 3; pixel_y = 9},/turf/open/floor/plasteel/white,/area/space)
"br" = (/obj/item/radio/intercom{pixel_y = -26},/obj/effect/turf_decal/tile/blue{dir = 4},/obj/effect/turf_decal/tile/blue{dir = 8},/obj/effect/decal/cleanable/blood/old,/turf/open/floor/plasteel/white,/area/space)
"bs" = (/obj/effect/turf_decal/tile/blue{dir = 8},/obj/effect/turf_decal/tile/blue,/obj/machinery/disposal/bin,/turf/open/floor/plasteel/white,/area/space)
"bt" = (/obj/machinery/smartfridge/organ,/obj/effect/turf_decal/tile/blue{dir = 8},/obj/effect/turf_decal/tile/blue{dir = 4},/turf/open/floor/plasteel/freezer,/area/space)
"bu" = (/obj/effect/decal/cleanable/dirt,/obj/item/flashlight/pen,/turf/open/floor/plasteel/white,/area/space)
"bv" = (/obj/structure/chair/sofa/left,/obj/item/storage/firstaid/regular,/turf/open/floor/carpet,/area/space)
"bw" = (/obj/item/storage/pill_bottle,/turf/open/floor/plasteel/white,/area/space)
"bx" = (/obj/item/surgicaldrill,/turf/open/floor/plasteel/white,/area/space)
"by" = (/obj/structure/table/glass,/obj/item/storage/backpack,/turf/open/floor/plasteel/white,/area/space)
"bz" = (/obj/machinery/computer/security/telescreen/entertainment{pixel_y = -32},/obj/effect/turf_decal/tile/blue{dir = 4},/obj/effect/turf_decal/tile/blue{dir = 8},/turf/open/floor/plasteel/white,/area/space)
"bA" = (/obj/structure/table/wood,/obj/item/flashlight/lamp,/obj/structure/sign/nanotrasen{pixel_x = 32},/obj/effect/turf_decal/tile/blue{dir = 4},/obj/effect/turf_decal/tile/blue{dir = 8},/turf/open/floor/plasteel/white,/area/space)
"bB" = (/obj/structure/table/reinforced,/obj/effect/turf_decal/tile/blue{dir = 8},/obj/effect/turf_decal/tile/blue,/obj/item/defibrillator,/obj/item/screwdriver,/turf/open/floor/plasteel/white,/area/space)
"bC" = (/obj/effect/decal/cleanable/blood/footprints{icon_state = "blood1"; dir = 8},/turf/open/floor/plasteel/white,/area/space)
"bD" = (/obj/item/flashlight/pen,/obj/effect/decal/cleanable/dirt/dust,/turf/open/floor/plasteel/white,/area/space)
"bE" = (/obj/effect/decal/cleanable/vomit,/turf/open/floor/plasteel/white,/area/space)
"bF" = (/obj/effect/decal/cleanable/dirt/dust,/turf/open/floor/plasteel/white,/area/space)
"bG" = (/obj/effect/decal/cleanable/oil{icon_state = "floor5"},/obj/effect/decal/cleanable/dirt/dust,/turf/open/floor/plasteel/white,/area/space)
"bH" = (/obj/effect/decal/cleanable/dirt/dust,/obj/structure/table/glass,/turf/open/floor/plasteel/white,/area/space)
"bI" = (/obj/effect/decal/cleanable/plastic,/obj/effect/decal/cleanable/blood/drip,/turf/open/floor/plasteel/white,/area/space)
"bJ" = (/obj/effect/turf_decal/tile/blue{dir = 4},/obj/effect/turf_decal/tile/blue{dir = 8},/obj/item/gamer_pamphlet,/turf/open/floor/plasteel/white,/area/space)
"bK" = (/obj/effect/decal/cleanable/oil,/turf/open/floor/plasteel/white,/area/space)
"bL" = (/obj/item/scalpel,/obj/item/stack/medical/gauze,/obj/structure/table/glass,/obj/machinery/light/small{icon_state = "bulb"; dir = 4},/turf/open/floor/plasteel/white,/area/space)
"bM" = (/obj/effect/decal/cleanable/robot_debris,/turf/open/floor/plasteel/white,/area/space)
"bN" = (/obj/effect/decal/cleanable/plasma,/obj/effect/decal/cleanable/insectguts,/turf/open/floor/plasteel/white,/area/space)
"bO" = (/obj/effect/decal/cleanable/greenglow,/obj/effect/decal/cleanable/glass,/turf/open/floor/plasteel/white,/area/space)
"bP" = (/obj/effect/decal/cleanable/blood/drip,/turf/open/floor/plasteel/white,/area/space)
"bQ" = (/obj/machinery/light/small,/obj/effect/decal/cleanable/dirt/dust,/turf/open/floor/plasteel/white,/area/space)
"bR" = (/obj/machinery/light/small{icon_state = "bulb"; dir = 4},/obj/effect/decal/cleanable/dirt/dust,/turf/open/floor/plasteel/white,/area/space)
"bS" = (/obj/machinery/atmospherics/components/unary/vent_pump/on,/obj/effect/decal/cleanable/dirt/dust,/turf/open/floor/plasteel/white,/area/space)

(1,1,1) = {"
boaeatatbDatatafafafbmbvaw
atatbFbbbwbxatafaxayasazaA
atbGbQatatbFatacaaatadaial
afafafafafatatafambSaIaBaC
aDaEababafbFbEafaFaHaNaOaP
aJaKaLaLaTatbRafafacafafaf
aLbcbnbtafaIatbNahbCbOatbH
afaWafafafatbIatbFatbPbKbL
bMbFatatatbuaVatbFbFatatby
afagaXajajakakakaYakakakak
aZanaoapaqakaraubJavaubaaG
aSaMaQaRalakaUbibdbebebfbg
bkbsbjbBblakbpbqauavbrbzbA
"}
