"aE" = (/obj/structure/window/reinforced{dir = 4},/obj/structure/window/reinforced,/turf/open/space,/area/space)
"aL" = (/obj/effect/turf_decal/tile/blue{dir = 1},/obj/item/bodypart/l_leg/robot{pixel_y = -11; pixel_x = 12},/obj/item/bodypart/chest/robot,/obj/item/stack/cable_coil,/turf/open/floor/plasteel/dark,/area/space)
"aP" = (/obj/machinery/power/apc/highcap/five_k{areastring = "/area/ai_monitored/turret_protected/aisat/foyer"; name = "MiniSat Foyer APC"; pixel_y = -23},/obj/effect/turf_decal/tile/blue{dir = 8},/obj/structure/showcase/cyborg/old{dir = 8; pixel_x = 9; pixel_y = 2},/obj/item/bodypart/chest/robot,/obj/item/circuitboard/computer/arcade/amputation,/obj/effect/decal/cleanable/oil{icon_state = "floor6"},/turf/open/floor/plasteel/dark,/area/space)
"br" = (/obj/effect/turf_decal/tile/blue{dir = 1},/obj/item/circuitboard/computer/arcade,/turf/open/floor/plasteel/dark,/area/space)
"bK" = (/obj/structure/table/wood,/obj/machinery/light/small{dir = 8},/obj/item/radio/off{pixel_y = 4},/obj/item/screwdriver{pixel_y = 10},/turf/open/floor/plasteel/grimy,/area/space)
"cD" = (/obj/structure/window/reinforced{dir = 4},/obj/structure/window/reinforced{dir = 8},/obj/item/stock_parts/cell/crap,/obj/effect/decal/cleanable/blood,/obj/effect/decal/cleanable/blood/tracks,/turf/open/floor/plasteel/dark,/area/space)
"hb" = (/obj/structure/showcase/cyborg/old{pixel_y = 20},/obj/effect/turf_decal/tile/blue{dir = 1},/obj/item/trash/boritos,/turf/open/floor/plasteel/dark,/area/space)
"hF" = (/obj/machinery/status_display/ai{pixel_y = 32},/obj/machinery/computer/security/telescreen{desc = "Used for watching the RD's goons from the safety of his office."; dir = 4; name = "Research Monitor"; network = list("rd"); pixel_x = -28},/obj/effect/turf_decal/tile/neutral{dir = 1},/obj/effect/turf_decal/tile/neutral,/obj/effect/turf_decal/tile/neutral{dir = 4},/obj/effect/turf_decal/tile/neutral{dir = 8},/obj/structure/showcase{icon = 'icons/obj/turrets.dmi'; icon_state = "turretCover"},/turf/open/floor/plasteel/dark,/area/space)
"ib" = (/obj/machinery/light/small,/obj/item/folder{pixel_x = -6; pixel_y = 2},/obj/item/folder{pixel_x = -4},/obj/machinery/camera{c_tag = "Telecomms - Control Room"; dir = 1; network = list("ss13","tcomms")},/obj/structure/table/wood,/obj/item/pen,/obj/item/toy/figure/borg{pixel_y = -1; pixel_x = 11},/turf/open/floor/plasteel/grimy,/area/space)
"ii" = (/obj/machinery/turretid{control_area = "/area/ai_monitored/turret_protected/aisat_interior"; name = "Antechamber Turret Control"; pixel_x = 30; req_access_txt = "65"},/obj/machinery/ai_slipper{uses = 10},/obj/effect/turf_decal/tile/blue{dir = 1},/turf/open/floor/plasteel/dark,/area/space)
"jb" = (/obj/machinery/door/firedoor,/obj/machinery/door/airlock/maintenance_hatch{name = "MiniSat Maintenance"; req_access_txt = null},/obj/effect/mapping_helpers/airlock/cyclelink_helper{dir = 4},/obj/structure/cable,/turf/open/floor/plasteel/dark,/area/space)
"kd" = (/obj/item/circuitboard/computer,/turf/open/floor/plasteel/dark,/area/space)
"kk" = (/obj/machinery/computer/station_alert{dir = 1},/obj/machinery/light,/obj/machinery/computer/security/telescreen/minisat{dir = 1; pixel_y = -29},/turf/open/floor/plasteel/dark,/area/space)
"kx" = (/obj/structure/showcase/cyborg/old{pixel_y = 20},/obj/item/trash/candle,/turf/open/floor/plasteel/grimy,/area/space)
"lc" = (/obj/machinery/status_display/evac{pixel_y = 32},/obj/effect/turf_decal/tile/neutral{dir = 1},/obj/effect/turf_decal/tile/neutral,/obj/effect/turf_decal/tile/neutral{dir = 4},/obj/effect/turf_decal/tile/neutral{dir = 8},/obj/machinery/power/port_gen/pacman,/obj/machinery/power/terminal{dir = 8},/turf/open/floor/plasteel/dark,/area/space)
"lj" = (/obj/machinery/light/small{dir = 4},/obj/effect/turf_decal/tile/blue,/mob/living/simple_animal/bot/cleanbot,/turf/open/floor/plasteel/dark,/area/space)
"lV" = (/obj/machinery/holopad/secure,/turf/open/floor/plasteel/grimy,/area/space)
"my" = (/obj/structure/window/reinforced{dir = 4},/obj/structure/window/reinforced{dir = 8},/obj/effect/decal/cleanable/blood/footprints,/turf/open/floor/plasteel/dark,/area/space)
"mP" = (/obj/item/circuitboard/computer/bounty,/turf/open/floor/plasteel/dark,/area/space)
"nd" = (/turf/open/floor/plasteel/dark,/area/space)
"ny" = (/obj/item/restraints/handcuffs/cable/zipties/used,/obj/item/restraints/handcuffs/cable/zipties/used{pixel_y = 3; pixel_x = -4},/obj/effect/decal/cleanable/oil{icon_state = "floor6"},/obj/effect/decal/cleanable/robot_debris/gib,/turf/open/floor/plasteel/dark,/area/space)
"oM" = (/obj/machinery/status_display/evac{pixel_y = 32},/obj/machinery/computer/security/telescreen/minisat{dir = 8; pixel_x = 28},/obj/effect/turf_decal/tile/neutral{dir = 1},/obj/effect/turf_decal/tile/neutral,/obj/effect/turf_decal/tile/neutral{dir = 4},/obj/effect/turf_decal/tile/neutral{dir = 8},/obj/structure/showcase{icon = 'icons/obj/turrets.dmi'; icon_state = "turretCover"},/turf/open/floor/plasteel/dark,/area/space)
"oT" = (/obj/effect/turf_decal/tile/blue{dir = 8},/obj/item/bodypart/head/robot{pixel_y = 7; pixel_x = 4},/obj/item/stack/cable_coil,/turf/open/floor/plasteel/dark,/area/space)
"pa" = (/obj/machinery/light/small{dir = 4},/obj/effect/turf_decal/tile/blue{dir = 4},/obj/effect/decal/cleanable/robot_debris,/turf/open/floor/plasteel/dark,/area/space)
"qX" = (/obj/structure/window/reinforced,/turf/open/space,/area/space)
"rm" = (/obj/machinery/holopad/secure,/turf/open/floor/plasteel/dark,/area/space)
"ry" = (/obj/machinery/light/small{dir = 8},/obj/machinery/airalarm{dir = 4; pixel_x = -22},/obj/effect/turf_decal/tile/blue{dir = 8},/mob/living/simple_animal/bot/floorbot,/turf/open/floor/plasteel/dark,/area/space)
"sk" = (/obj/structure/chair/office{dir = 4},/turf/open/floor/plasteel/grimy,/area/space)
"su" = (/obj/machinery/computer/teleporter,/obj/effect/turf_decal/tile/neutral{dir = 1},/obj/effect/turf_decal/tile/neutral,/obj/effect/turf_decal/tile/neutral{dir = 4},/obj/effect/turf_decal/tile/neutral{dir = 8},/turf/open/floor/plasteel/dark,/area/space)
"sK" = (/obj/structure/window/reinforced,/obj/structure/window/reinforced{dir = 4},/turf/open/space,/area/space)
"sZ" = (/obj/structure/window/reinforced,/obj/structure/window/reinforced{dir = 1; layer = 2.9},/turf/open/floor/plasteel/dark,/area/space)
"tO" = (/obj/machinery/light,/obj/effect/turf_decal/tile/blue{dir = 8},/obj/item/bodypart/l_arm/robot{pixel_y = 4; pixel_x = 2},/obj/item/bodypart/l_arm/robot,/turf/open/floor/plasteel/dark,/area/space)
"uO" = (/obj/item/stock_parts/cell/crap,/obj/effect/decal/cleanable/oil,/turf/open/floor/plasteel/dark,/area/space)
"uV" = (/obj/structure/window/reinforced{dir = 1; layer = 2.9},/turf/open/floor/plasteel/dark,/area/space)
"vf" = (/obj/machinery/announcement_system,/turf/open/floor/plasteel/grimy,/area/space)
"vH" = (/obj/machinery/door/firedoor,/obj/machinery/door/airlock/hatch{name = "MiniSat Antechamber"; req_one_access_txt = null},/obj/effect/mapping_helpers/airlock/cyclelink_helper{dir = 8},/obj/structure/cable,/turf/open/floor/plasteel/dark,/area/space)
"wF" = (/obj/item/bodypart/l_leg/robot{pixel_y = 12; pixel_x = -11},/obj/item/bodypart/head/robot{pixel_y = -7; pixel_x = -7},/obj/item/stack/cable_coil,/obj/item/stack/cable_coil{pixel_x = -3; pixel_y = 3},/turf/open/floor/plasteel/dark,/area/space)
"xF" = (/obj/structure/showcase/cyborg/old{pixel_y = 20},/obj/effect/turf_decal/tile/blue{dir = 4},/obj/item/circuitboard/computer/aifixer,/turf/open/floor/plasteel/dark,/area/space)
"xJ" = (/obj/machinery/computer/telecomms/monitor{dir = 8; network = "tcommsat"},/turf/open/floor/plasteel/grimy,/area/space)
"ya" = (/obj/effect/turf_decal/tile/blue{dir = 4},/turf/open/floor/plasteel/dark,/area/space)
"yr" = (/obj/machinery/light_switch{pixel_y = 28},/obj/structure/showcase/cyborg/old{pixel_y = 20},/turf/open/floor/plasteel/grimy,/area/space)
"yN" = (/obj/machinery/requests_console{announcementConsole = 1; department = "Telecomms Admin"; departmentType = 5; name = "Telecomms RC"; pixel_y = -30},/obj/item/paper_bin{pixel_x = -1; pixel_y = 6},/obj/structure/table/wood,/obj/item/stock_parts/cell/emproof{pixel_y = -4; pixel_x = -4},/obj/item/stock_parts/cell/emproof{pixel_x = 6},/turf/open/floor/plasteel/grimy,/area/space)
"zb" = (/obj/structure/chair/office{dir = 8},/turf/open/floor/plasteel/grimy,/area/space)
"AB" = (/obj/machinery/holopad/secure,/obj/item/bodypart/r_arm/robot{pixel_y = 2; pixel_x = -2},/obj/item/bodypart/r_arm/robot,/obj/effect/decal/cleanable/oil{icon_state = "floor5"},/turf/open/floor/plasteel/dark,/area/space)
"AO" = (/obj/structure/window/reinforced{dir = 4},/turf/open/space,/area/space)
"Bd" = (/obj/structure/window/reinforced{dir = 4},/obj/structure/window/reinforced{dir = 8},/obj/item/trash/boritos,/turf/open/floor/plasteel/dark,/area/space)
"Bf" = (/obj/structure/table/wood,/obj/machinery/status_display/evac{pixel_y = 31},/obj/item/book/manual/wiki/tcomms,/obj/item/folder/blue,/obj/item/pen,/obj/item/circuitboard/computer/arcade/orion_trail,/turf/open/floor/plasteel/grimy,/area/space)
"CL" = (/obj/item/restraints/handcuffs/cable/zipties/used{pixel_y = 10; pixel_x = 7},/turf/open/floor/plasteel/dark,/area/space)
"DZ" = (/obj/item/circuitboard/computer/atmos_control/incinerator,/turf/open/floor/plasteel/grimy,/area/space)
"Ei" = (/obj/structure/window/reinforced,/turf/open/space/basic,/area/space)
"EM" = (/obj/structure/window/reinforced{dir = 8},/obj/structure/window/reinforced{dir = 4},/turf/open/floor/plasteel/dark,/area/space)
"EW" = (/obj/effect/turf_decal/tile/blue,/obj/item/circuitboard,/turf/open/floor/plasteel/dark,/area/space)
"Ft" = (/turf/closed/wall/r_wall,/area/space)
"Fv" = (/obj/structure/filingcabinet{pixel_x = 3},/turf/open/floor/plasteel/grimy,/area/space)
"FH" = (/obj/effect/decal/cleanable/oil{icon_state = "floor6"},/obj/effect/decal/cleanable/robot_debris/old,/turf/open/floor/plasteel/dark,/area/space)
"FT" = (/obj/effect/decal/cleanable/vomit/old,/turf/open/floor/plasteel/grimy,/area/space)
"Ge" = (/obj/structure/showcase/cyborg/old{dir = 8; pixel_x = 9; pixel_y = 2},/obj/effect/turf_decal/stripes/line{dir = 1},/obj/item/trash/sosjerky,/turf/open/floor/plasteel/dark,/area/space)
"Gm" = (/obj/machinery/door/airlock/hatch{name = "Telecomms Control Room"; req_one_access_txt = null},/obj/machinery/atmospherics/pipe/simple/supply/hidden,/obj/effect/mapping_helpers/airlock/cyclelink_helper{dir = 1},/obj/effect/turf_decal/tile/neutral{dir = 1},/obj/effect/turf_decal/tile/neutral,/obj/effect/turf_decal/tile/neutral{dir = 4},/obj/effect/turf_decal/tile/neutral{dir = 8},/obj/structure/cable,/obj/machinery/navbeacon/wayfinding,/turf/open/floor/plasteel/dark,/area/space)
"GK" = (/obj/effect/turf_decal/tile/blue{dir = 1},/obj/item/restraints/handcuffs/cable/zipties/used{pixel_y = -2; pixel_x = 10},/obj/effect/decal/cleanable/oil,/turf/open/floor/plasteel/dark,/area/space)
"Hn" = (/turf/open/floor/plasteel/grimy,/area/space)
"Hs" = (/obj/structure/window/reinforced{dir = 4},/obj/structure/window/reinforced{dir = 8},/turf/open/floor/plasteel/dark,/area/space)
"HV" = (/obj/effect/turf_decal/stripes/line{dir = 1},/obj/effect/decal/cleanable/oil,/obj/effect/decal/cleanable/shreds,/turf/open/floor/plasteel/dark,/area/space)
"IA" = (/obj/machinery/door/airlock/hatch{name = "MiniSat Antechamber"; req_one_access_txt = null},/turf/open/floor/plasteel/dark,/area/space)
"JT" = (/obj/effect/decal/cleanable/oil{icon_state = "floor5"},/turf/open/floor/plasteel/dark,/area/space)
"Kn" = (/obj/machinery/teleport/hub,/obj/effect/turf_decal/tile/neutral{dir = 1},/obj/effect/turf_decal/tile/neutral,/obj/effect/turf_decal/tile/neutral{dir = 4},/obj/effect/turf_decal/tile/neutral{dir = 8},/turf/open/floor/plasteel/dark,/area/space)
"Lr" = (/obj/effect/decal/cleanable/plastic,/turf/open/floor/plasteel/dark,/area/space)
"LC" = (/obj/structure/window/reinforced{dir = 1; layer = 2.9},/obj/structure/window/reinforced,/obj/item/trash/chips,/turf/open/floor/plasteel/dark,/area/space)
"LN" = (/obj/structure/window/reinforced,/obj/structure/window/reinforced{dir = 4},/obj/item/trash/candy,/turf/open/floor/plasteel/dark,/area/space)
"Nb" = (/obj/machinery/ai_slipper{uses = 10},/mob/living/simple_animal/bot/secbot/pingsky,/turf/open/floor/plasteel/dark,/area/space)
"Nw" = (/obj/machinery/atmospherics/components/unary/portables_connector/visible{name = "Auxiliary MiniSat Distribution Port"},/obj/machinery/portable_atmospherics/canister/air,/obj/effect/turf_decal/tile/neutral{dir = 1},/obj/effect/turf_decal/tile/neutral,/obj/effect/turf_decal/tile/neutral{dir = 4},/obj/effect/turf_decal/tile/neutral{dir = 8},/turf/open/floor/plasteel/dark,/area/space)
"NF" = (/obj/machinery/status_display/evac{pixel_y = 32},/turf/open/floor/plasteel/dark,/area/space)
"NI" = (/obj/structure/window/reinforced{dir = 1; layer = 2.9},/obj/structure/window/reinforced,/turf/open/floor/plasteel/dark,/area/space)
"NP" = (/obj/machinery/door/airlock/hatch{name = "Telecomms Control Room"; req_one_access_txt = null},/turf/open/floor/plating,/area/space)
"NX" = (/obj/machinery/computer/message_monitor{dir = 4},/turf/open/floor/plasteel/grimy,/area/space)
"Oa" = (/obj/effect/turf_decal/tile/neutral{dir = 1},/obj/effect/turf_decal/tile/neutral,/obj/effect/turf_decal/tile/neutral{dir = 4},/obj/effect/turf_decal/tile/neutral{dir = 8},/obj/machinery/recharge_station,/turf/open/floor/plasteel/dark,/area/space)
"Oh" = (/obj/structure/window/reinforced{dir = 4},/obj/structure/window/reinforced{dir = 8},/obj/effect/decal/cleanable/blood/footprints,/obj/effect/decal/cleanable/blood/tracks,/turf/open/floor/plasteel/dark,/area/space)
"OF" = (/obj/machinery/light/small,/obj/item/storage/box/donkpockets,/obj/structure/table/wood,/turf/open/floor/plasteel/grimy,/area/space)
"OY" = (/obj/item/trash/sosjerky,/turf/open/floor/plasteel/dark,/area/space)
"Pg" = (/obj/structure/window/reinforced,/obj/item/trash/cheesie{pixel_y = 4; pixel_x = -3},/obj/item/trash/cheesie,/turf/open/floor/plasteel/dark,/area/space)
"Pr" = (/obj/structure/window/reinforced{dir = 4},/obj/structure/window/reinforced{dir = 8},/obj/item/circuitboard/computer/xenobiology,/turf/open/floor/plasteel/dark,/area/space)
"Pw" = (/obj/structure/window/reinforced,/obj/structure/window/reinforced{dir = 8},/turf/open/space,/area/space)
"Px" = (/obj/machinery/camera/motion{c_tag = "MiniSat Maintenance"; dir = 8; network = list("minisat")},/obj/item/stock_parts/cell/crap,/turf/open/floor/plasteel/dark,/area/space)
"QW" = (/obj/machinery/status_display/evac{pixel_y = 32},/obj/effect/turf_decal/tile/neutral{dir = 1},/obj/effect/turf_decal/tile/neutral,/obj/effect/turf_decal/tile/neutral{dir = 4},/obj/effect/turf_decal/tile/neutral{dir = 8},/obj/structure/showcase{icon = 'icons/obj/machines/teleporter.dmi'; icon_state = "controller"},/turf/open/floor/plasteel/dark,/area/space)
"QY" = (/obj/structure/table/wood,/obj/machinery/status_display/ai{pixel_y = 31},/obj/item/flashlight/lamp,/turf/open/floor/plasteel/grimy,/area/space)
"Ra" = (/obj/item/stock_parts/cell/crap,/turf/open/floor/plasteel/dark,/area/space)
"RM" = (/obj/item/circuitboard/computer/crew,/turf/open/floor/plasteel/grimy,/area/space)
"RU" = (/obj/machinery/light/small{dir = 8},/obj/machinery/camera{c_tag = "MiniSat - Antechamber"; dir = 4; network = list("minisat")},/obj/effect/turf_decal/tile/blue{dir = 1},/obj/effect/decal/cleanable/robot_debris/limb,/turf/open/floor/plasteel/dark,/area/space)
"Tz" = (/obj/structure/chair/office,/turf/open/floor/plasteel/grimy,/area/space)
"TK" = (/obj/item/radio/intercom{pixel_y = -28},/obj/structure/rack,/obj/item/storage/toolbox/mechanical,/obj/item/storage/toolbox/electrical{pixel_x = -3; pixel_y = 3},/obj/item/multitool,/obj/item/trash/can/food/peaches/maint,/turf/open/floor/plasteel/dark,/area/space)
"TM" = (/obj/machinery/light/small{dir = 4},/obj/item/radio/intercom{dir = 8; freerange = 1; name = "Station Intercom (Telecomms)"; pixel_y = 30},/obj/structure/table/wood,/obj/item/phone{pixel_x = -3; pixel_y = 3},/obj/item/cigbutt/cigarbutt{pixel_x = 5; pixel_y = -1},/obj/machinery/computer/security/telescreen{dir = 8; name = "Telecomms Camera Monitor"; network = list("tcomms"); pixel_x = 26},/turf/open/floor/plasteel/grimy,/area/space)
"TY" = (/obj/effect/decal/cleanable/oil/slippery,/turf/open/floor/plasteel/dark,/area/space)
"UH" = (/obj/effect/spawner/structure/window/reinforced,/turf/open/floor/plasteel/dark,/area/space)
"UU" = (/obj/item/computer_hardware/battery,/obj/effect/decal/cleanable/oil{icon_state = "floor5"},/turf/open/floor/plasteel/dark,/area/space)
"Vk" = (/obj/item/kirbyplants{icon_state = "plant-21"},/turf/open/floor/plasteel/grimy,/area/space)
"VB" = (/obj/machinery/microwave{pixel_y = 4},/obj/structure/table/wood,/turf/open/floor/plasteel/grimy,/area/space)
"VL" = (/obj/machinery/computer/telecomms/server{dir = 8; network = "tcommsat"},/turf/open/floor/plasteel/grimy,/area/space)
"Wb" = (/obj/structure/chair/office{dir = 1},/turf/open/floor/plasteel/grimy,/area/space)
"Ww" = (/obj/effect/turf_decal/tile/blue{dir = 8},/turf/open/floor/plasteel/dark,/area/space)
"XA" = (/obj/structure/window/reinforced,/obj/structure/window/reinforced{dir = 8},/obj/item/circuitboard/computer/holodeck,/obj/effect/decal/cleanable/blood/tracks{icon_state = "tracks"; dir = 10},/obj/effect/decal/cleanable/blood/gibs/old,/turf/open/floor/plasteel/dark,/area/space)
"XM" = (/obj/structure/window/reinforced{dir = 1; layer = 2.9},/obj/item/trash/chips,/turf/open/floor/plasteel/dark,/area/space)
"Yw" = (/obj/structure/window/reinforced{dir = 4},/obj/structure/window/reinforced{dir = 8},/obj/item/trash/candy,/turf/open/floor/plasteel/dark,/area/space)
"YX" = (/obj/effect/turf_decal/stripes/line{dir = 1},/obj/item/computer_hardware/battery,/turf/open/floor/plasteel/dark,/area/space)
"ZM" = (/obj/structure/window/reinforced{dir = 8},/turf/open/space,/area/space)

(1,1,1) = {"
suQWKnFthFhbNFxFoMFtlcNwOa
braLiiFtRUGKrmyapaFtYXHVGe
uOABwFvHTYndNbUUndjbJTmPFH
oTtOaPFtkdnyCLLrRaFtkkTKPx
IAFtFtFtryWwOYEWljFtFtFtIA
BdZMFtFtFtFtGmFtFtFtFtAOHs
HsZMFtbKBfkxHnyrQYTMFtAOHs
cDZMUHvfWbHnFTDZskxJUHAOYw
OhZMUHNXzbRMlVHnTzVLUHAOHs
myZMFtVBOFVkHnFvibyNFtAOPr
myZMFtFtFtFtNPFtFtFtFtAOHs
HsPwqXqXqXsKHsPwqXEiqXaEEM
XAsZXMuVNINIPgNINILCNINILN
"}
