"ak" = (/obj/structure/table/wood,/obj/item/flashlight/lamp,/turf/open/floor/wood,/area/space)
"aB" = (/obj/structure/closet/crate,/obj/effect/spawner/lootdrop/maintenance/three,/turf/open/floor/plating,/area/space)
"aD" = (/obj/effect/decal/cleanable/dirt/dust,/obj/item/reagent_containers/food/drinks/sillycup,/obj/item/reagent_containers/food/drinks/sillycup{pixel_x = -5; pixel_y = 3},/obj/item/reagent_containers/food/drinks/sillycup{pixel_x = 5; pixel_y = 3},/obj/structure/window/reinforced{dir = 4; tag = "pharena"},/turf/open/floor/plasteel/white,/area/space)
"aQ" = (/obj/item/trash/candle,/turf/open/floor/plating,/area/space)
"by" = (/obj/effect/decal/cleanable/dirt/dust,/obj/item/trash/sosjerky,/turf/open/floor/plating,/area/space)
"cm" = (/obj/structure/closet,/obj/effect/turf_decal/stripes/line,/obj/effect/spawner/lootdrop/maintenance/two,/turf/open/floor/plating,/area/space)
"dl" = (/obj/structure/closet/firecloset,/turf/open/floor/plating,/area/space)
"dQ" = (/obj/structure/closet/crate,/obj/item/poster/random_official,/obj/effect/turf_decal/stripes/line{dir = 1},/turf/open/floor/plating,/area/space)
"el" = (/obj/machinery/space_heater,/obj/effect/turf_decal/stripes/line{dir = 1},/turf/open/floor/plating,/area/space)
"eu" = (/obj/effect/decal/cleanable/dirt/dust,/obj/structure/table/reinforced,/obj/item/book/manual/wiki/surgery,/obj/item/storage/fancy/cigarettes/cigpack_uplift,/turf/open/floor/plasteel/white,/area/space)
"fA" = (/obj/effect/decal/cleanable/dirt/dust,/obj/structure/closet/crate/medical,/turf/open/floor/plasteel/white,/area/space)
"fB" = (/obj/structure/table/wood,/obj/item/reagent_containers/syringe/contraband/space_drugs,/obj/item/reagent_containers/syringe/contraband/space_drugs{pixel_y = 4; pixel_x = 2},/turf/open/floor/carpet,/area/space)
"ga" = (/obj/effect/turf_decal/stripes/line{dir = 4},/obj/item/trash/chips,/turf/open/floor/plating,/area/space)
"gy" = (/turf/open/floor/plating{icon_state = "platingdmg3"},/area/space)
"gA" = (/turf/open/floor/plating{icon_state = "platingdmg2"},/area/space)
"gG" = (/obj/effect/decal/cleanable/dirt/dust,/obj/structure/chair/office/light,/turf/open/floor/plasteel/white,/area/space)
"hm" = (/obj/structure/table/wood,/obj/machinery/newscaster{pixel_y = 32},/obj/item/reagent_containers/food/snacks/grown/cannabis{pixel_y = 3; pixel_x = -5},/obj/item/reagent_containers/food/snacks/grown/cannabis{pixel_x = 8; pixel_y = 9},/obj/item/reagent_containers/food/snacks/grown/cannabis,/obj/item/reagent_containers/food/snacks/grown/cannabis/white{pixel_y = 12; pixel_x = -4},/turf/open/floor/wood,/area/space)
"hT" = (/obj/effect/decal/cleanable/dirt/dust,/turf/open/floor/plasteel/white,/area/space)
"hY" = (/obj/structure/closet,/obj/item/storage/box/lights/mixed,/obj/effect/turf_decal/stripes/line{dir = 1},/turf/open/floor/plating,/area/space)
"jJ" = (/obj/structure/sign/warning/biohazard{pixel_y = 32},/obj/item/trash/sosjerky,/turf/open/floor/plating,/area/space)
"kX" = (/obj/effect/decal/cleanable/dirt/dust,/obj/vehicle/ridden/wheelchair,/turf/open/floor/plating{icon_state = "panelscorched"},/area/space)
"lm" = (/obj/effect/decal/cleanable/dirt,/obj/effect/turf_decal/stripes/line{dir = 8},/turf/open/floor/plating,/area/space)
"lX" = (/obj/effect/decal/cleanable/dirt/dust,/turf/open/floor/plating,/area/space)
"nT" = (/obj/structure/table/wood,/obj/item/stack/spacecash/c20,/obj/item/stack/spacecash/c20{pixel_y = 10},/obj/item/stack/spacecash/c20{pixel_y = 6; pixel_x = 4},/obj/item/stack/spacecash/c20{pixel_x = -4; pixel_y = 4},/obj/item/stack/spacecash/c20{pixel_x = 4; pixel_y = -2},/turf/open/floor/wood,/area/space)
"oC" = (/obj/machinery/smartfridge/drying_rack,/turf/open/floor/wood,/area/space)
"oN" = (/obj/item/trash/raisins,/turf/open/floor/plating,/area/space)
"pb" = (/turf/open/floor/plating,/area/space)
"pE" = (/obj/structure/chair/comfy/black{dir = 4},/turf/open/floor/carpet,/area/space)
"pS" = (/obj/effect/decal/cleanable/dirt/dust,/turf/open/floor/wood,/area/space)
"qD" = (/obj/effect/decal/cleanable/dirt/dust,/turf/open/floor/plating{icon_state = "panelscorched"},/area/space)
"qI" = (/obj/machinery/door/airlock/grunge,/obj/effect/decal/cleanable/dirt/dust,/turf/open/floor/plasteel,/area/space)
"qM" = (/obj/structure/reagent_dispensers/watertank,/obj/item/storage/box/lights/mixed,/obj/structure/sign/poster/contraband/random{pixel_y = 32},/turf/open/floor/plating,/area/space)
"ri" = (/obj/structure/closet/emcloset,/turf/open/floor/plating,/area/space)
"ru" = (/obj/effect/turf_decal/stripes/line,/obj/effect/decal/cleanable/dirt/dust,/turf/open/floor/plating,/area/space)
"sT" = (/obj/effect/decal/cleanable/dirt/dust,/turf/open/floor/plating,/area/space)
"ti" = (/obj/machinery/door/airlock/maintenance{name = "Storage Room"; req_one_access_txt = "12;47"},/obj/effect/mapping_helpers/airlock/abandoned,/turf/open/floor/plating,/area/space)
"tl" = (/obj/structure/closet/emcloset,/turf/open/floor/plating,/area/space)
"vt" = (/obj/structure/table/wood,/obj/item/clothing/mask/cigarette/rollie/cannabis{pixel_x = -5; pixel_y = 3},/obj/item/clothing/mask/cigarette/rollie/cannabis{pixel_y = 4; pixel_x = 5},/obj/item/clothing/mask/cigarette/rollie/cannabis,/turf/open/floor/wood,/area/space)
"vu" = (/obj/structure/reagent_dispensers/water_cooler,/obj/effect/decal/cleanable/dirt/dust,/obj/structure/window/reinforced{dir = 4; tag = "pharena"},/turf/open/floor/plasteel/white,/area/space)
"wI" = (/obj/structure/rack,/obj/effect/spawner/lootdrop/costume,/obj/effect/spawner/lootdrop/maintenance/two,/obj/effect/turf_decal/stripes/line,/turf/open/floor/plating,/area/space)
"yp" = (/turf/open/floor/carpet,/area/space)
"ze" = (/obj/effect/decal/cleanable/dirt/dust,/obj/structure/closet/cardboard,/obj/item/toy/plush/lizardplushie{name = "Tends-the-Wounds"},/obj/structure/window/reinforced{dir = 4; tag = "pharena"},/turf/open/floor/plating,/area/space)
"zh" = (/obj/item/trash/chips,/turf/open/floor/carpet,/area/space)
"zV" = (/obj/effect/decal/cleanable/dirt/dust,/turf/open/floor/plating,/area/space)
"As" = (/obj/structure/table/wood,/obj/item/storage/fancy/rollingpapers{pixel_y = 1},/obj/item/rollingpaper{pixel_y = 8; pixel_x = 7},/obj/item/rollingpaper{pixel_y = -6; pixel_x = -8},/turf/open/floor/carpet,/area/space)
"Ax" = (/obj/effect/decal/cleanable/dirt/dust,/obj/structure/window/reinforced{dir = 4; tag = "pharena"},/turf/open/floor/plasteel/white,/area/space)
"AC" = (/turf/closed/wall,/area/space)
"AH" = (/obj/structure/chair/office{dir = 8},/obj/effect/decal/cleanable/dirt/dust,/turf/open/floor/carpet,/area/space)
"Cm" = (/obj/effect/decal/cleanable/dirt/dust,/turf/open/floor/plasteel/white,/area/space)
"Cr" = (/turf/open/floor/wood,/area/space)
"CC" = (/obj/structure/table/wood,/obj/item/stack/sheet/mineral/silver{amount = 50},/turf/open/floor/wood,/area/space)
"CZ" = (/obj/item/trash/cheesie,/obj/item/trash/cheesie{pixel_y = 5; pixel_x = 4},/turf/open/floor/plating,/area/space)
"Ee" = (/obj/item/trash/pistachios,/turf/open/floor/plating,/area/space)
"Ez" = (/obj/effect/turf_decal/stripes/line{dir = 1},/turf/open/floor/plating,/area/space)
"FX" = (/obj/structure/sign/poster/contraband/random{pixel_y = -32},/turf/open/floor/plating,/area/space)
"Gl" = (/obj/structure/closet,/turf/open/floor/plating,/area/space)
"Go" = (/obj/structure/closet,/obj/effect/decal/cleanable/dirt/dust,/turf/open/floor/plating,/area/space)
"Gq" = (/obj/effect/decal/cleanable/dirt/dust,/obj/item/trash/energybar{pixel_y = 4; pixel_x = -4},/obj/item/trash/energybar,/turf/open/floor/plating,/area/space)
"HB" = (/obj/effect/decal/cleanable/dirt/dust,/turf/open/floor/plasteel/white,/area/space)
"HR" = (/obj/item/reagent_containers/food/snacks/candy_trash,/turf/open/floor/plating,/area/space)
"Iv" = (/obj/structure/reagent_dispensers/watertank,/turf/open/floor/plating,/area/space)
"IU" = (/obj/effect/decal/cleanable/dirt/dust,/obj/structure/table/reinforced,/obj/item/storage/box/lights/mixed,/obj/item/cigbutt/cigarbutt,/obj/item/candle{pixel_x = -5},/obj/item/storage/box/matches{pixel_x = 1; pixel_y = -1},/obj/structure/window/reinforced,/turf/open/floor/plasteel/white,/area/space)
"Jj" = (/obj/effect/decal/cleanable/dirt/dust,/obj/structure/table/reinforced,/obj/item/clothing/gloves/color/blue{desc = "An old pair of nitrile gloves, with no sterile properties."; name = "old nitrile gloves"},/obj/item/clothing/mask/surgical,/obj/item/clothing/suit/apron/surgical,/obj/item/reagent_containers/glass/rag,/obj/structure/window/reinforced,/turf/open/floor/plasteel/white,/area/space)
"Jo" = (/obj/effect/decal/cleanable/dirt/dust,/obj/structure/rack,/obj/item/reagent_containers/blood/random,/obj/item/reagent_containers/food/drinks/bottle/vodka,/obj/structure/window/reinforced,/turf/open/floor/plasteel/white,/area/space)
"JQ" = (/obj/structure/grille,/turf/open/floor/plating,/area/space)
"Ka" = (/obj/structure/chair/office{dir = 8},/turf/open/floor/wood,/area/space)
"Kr" = (/obj/effect/decal/cleanable/dirt/dust,/obj/structure/windoor_assembly{dir = 2},/turf/open/floor/plasteel/white,/area/space)
"KL" = (/obj/item/trash/semki,/turf/open/floor/plating,/area/space)
"MU" = (/obj/effect/decal/cleanable/dirt/dust,/obj/machinery/iv_drip,/obj/structure/window/reinforced,/obj/structure/window/reinforced{dir = 4; tag = "pharena"},/turf/open/floor/plating,/area/space)
"Oy" = (/turf/open/floor/plating{icon_state = "platingdmg1"},/area/space)
"OG" = (/obj/item/storage/bag/trash,/turf/open/floor/wood,/area/space)
"OZ" = (/obj/machinery/door/airlock/maintenance,/turf/open/floor/plating,/area/space)
"Pj" = (/obj/machinery/door/airlock{name = "Unisex Restroom"},/obj/effect/decal/cleanable/dirt/dust,/turf/open/floor/plasteel,/area/space)
"Pu" = (/obj/effect/decal/cleanable/dirt/dust,/obj/structure/rack,/obj/item/skub{name = "medicinal skub"},/obj/item/toy/cattoy,/turf/open/floor/plating,/area/space)
"PP" = (/obj/item/trash/syndi_cakes,/turf/open/floor/plating,/area/space)
"Qf" = (/obj/effect/decal/cleanable/dirt,/obj/structure/reagent_dispensers/watertank,/obj/effect/turf_decal/stripes/line,/turf/open/floor/plating,/area/space)
"Qx" = (/obj/effect/decal/cleanable/dirt/dust,/obj/item/trash/candy,/turf/open/floor/plating,/area/space)
"QN" = (/obj/item/trash/energybar,/turf/open/floor/plating,/area/space)
"Ru" = (/obj/structure/rack,/obj/item/trash/can/food/beans,/turf/open/floor/plating,/area/space)
"RY" = (/obj/effect/decal/cleanable/dirt/dust,/turf/open/floor/plasteel/white,/area/space)
"Sd" = (/obj/structure/table/wood,/obj/item/stack/sheet/mineral/gold{amount = 50},/turf/open/floor/wood,/area/space)
"TD" = (/obj/structure/reagent_dispensers/fueltank,/turf/open/floor/plating,/area/space)
"TZ" = (/obj/structure/closet/crate/trashcart/laundry,/turf/open/floor/plating,/area/space)
"UH" = (/obj/item/storage/box/lights/mixed,/turf/open/floor/plating,/area/space)
"Wf" = (/obj/structure/rack,/obj/item/storage/fancy/rollingpapers{pixel_y = 4; pixel_x = 3},/obj/item/storage/fancy/rollingpapers,/turf/open/floor/wood,/area/space)
"WM" = (/obj/structure/rack,/obj/item/trash/can/food/peaches/maint,/turf/open/floor/plating,/area/space)
"Xt" = (/obj/effect/decal/cleanable/dirt/dust,/turf/open/floor/plating,/area/space)
"YB" = (/obj/effect/decal/cleanable/dirt/dust,/obj/structure/bed/roller,/obj/item/pizzabox/pineapple{pixel_y = 6},/turf/open/floor/plasteel/white,/area/space)
"YE" = (/obj/item/trash/candy,/turf/open/floor/plating,/area/space)
"ZG" = (/obj/structure/chair/office{dir = 4},/turf/open/floor/wood,/area/space)

(1,1,1) = {"
PuYBkXfAvudltlACtlqMaBpbpb
XtGqRYRYaDbypbACpbgApbpbpb
RYRYXtRYAxXtXtOZpbpbpbEepb
eugGqDXtzeXtpbACIvTDACpbpb
IUJjJoKrMUQxXtACACACACpbPP
pbQNruXtXtpbpbCZpbpbHRpbpb
ACACqIACGoWMpbXtaQpbKLpbTZ
CCSdpSACACACpbACOZACACOZAC
SdKaCrvthmACoNACEzjJpbFXJQ
oCCrpEfBAHPjpbACpbACACACAC
CrCrpEAsypACpbYEgyACwIQfcm
ZGCrzhypypACpbpbgatilmUHOy
nTakCrOGWfACIvRuGlACeldQhY
"}
